                                                                                                   
                                                                                                   
                                                                                                   
                                                                                                   
                                                                                                   
                                                                                                   
                         1111111111111111111111111111111                                           
                         1000000000000000000000000000001                                           
                         1000000000000000000000000000001                                           
                         1000000000000000000000000000001                                           
                         100000000000000000000000000000111111                                      
                         100000000000000000000000000000000001                                      
                         100000000000000000000000000000000001                                      
                         100000000000000000000000000000000001                                      
                         100000000000000000000000000000111111                                      
                         1000000000000000000000000000001                                           
                         1000000000000000000000000000001                                           
                         1000000000000000000000000000001                                           
                         100000000000000000000000000000111111111111111                             
                         100000000000000000000000000000000000000000001                             
                         100000000000000000000000000000000000000000001                             
                         100000000000000000000000000000000000000000001                             
                         100000000000000000000000000000111111111110001                             
                         1000000000000000000000000000001         10001                             
                         1000000000000000000000000000001   11111110001111111                       
                         1000000000000000000000000000001   10000000000000001                       
11111111111111111111111111000000000000000000000000000001   10000000000000001                       
10000000000000000000000000000000000000000000000000000001   10000000000000001                       
10000000000000000000000000000000000000000000000000000001   10000000000000001                       
10000000000000000000000000000000000000000000000000000001   10000000000000001                       
11111111111111111111111111000000000000000000000000000001   10000000000000001                       
                         1000000000000000000000000000001   10000000000000001                       
                         1000000000000000000000000000001   10000000000000001                       
                         1000000000000000000000000000001   10000000000000001                       
                         1111111111111111111111111111111   10000000000000001                       
                                                           11111110001111111                       
                                                                 10001                             
                                                                 10001                             
                                                                 10001                             
                                                                 1000111111111111111111111111111111
                                                                 1000000000000000000000000000000001
                                                                 1000000000000000000000000000000001
                                                                 1000000000000000000000000000000001
                                                                 1111111111111111111111111111111111
                                                                                                   