  111111                 
 1000001                 
10000001                 
10000001                 
10000001                 
11100111                 
  1001                   
  1001                   
11100111111111           
10000000000001           
10000000000001           
10000000000001           
11111111001111           
       1001              
       1##1              
       1001              
       100111111111111111
       100000000000000001
       100000000000000001