  111111
 1000001
10000001
10000001
10000001
11111111