            111111111111111111111111                          
            100000000000000000000001                          
            100000000000000000000001                          
            100000000000000000000001                1111111111
            100000000000000000000001                1000000001
11111111111110000000000000000000000111111111111111111000000001
00000000000000000000000000000000000000000000000000000000000001
00000000000000000000000000000000000000000000000000000000000001
11111111111110000000000000000000000111111111111111111000000001
            100000000000000000000001                1000000001
            100000000000000000000001                1111001111
            100000000000000000000001                   1001   
            100000000000000000000001                   1001   
            111111111111111111111111                   1001   
                                                       1001   
    1111111111111111111111111111111111111111111111111111001   
    1000000000000000000000000000000000000000000000000000001   
    1000000000000000000000000000000000000000000000000000001   
    1111111111111111111111111000111111111111111111111111001   
                          100000001                    1001   
                          100000001                    1001   
                          100000001                    1001   
                          100000001                    1001   
                          100000001                  11100111 
                          100000001                  10000001 
                          111000111                  10000001 
           1111             10001                    10000001 
           1001             10001                    10000001 
111111111111001111111111111110001                    10000001 
100000000000000000000000000000001                    11111111 
100000000000000000000000000000001                             
100000000000000000000000000000001                             
111001111111111111111001111111111                             
  1001              1001                                      
11100111            1111                                      
10000001                                                      
10000001                                                      
10000001                                                      
10000001                                                      
10000001                                                      
11111111                                                      