                                                                                                   
                                                                                                   
                        1111111111111111111111111111111111111111111111111111                       
                        1000000000000000000000000000000000000000000000000001                       
         1111111111111111000000000000000000000000000000000000000000000000001                       
         0000000000000000000000000000000000000000000000000000000000000000001                       
         0000000000000000000000000000000000000000000000000000000000000000001                       
         0000000000000000000000000000000000000000000000000000000000000000001                       
         1111111111111111000000000000000000000000000000000000000000000000001                       
                        1000000000000000000000000000000000000000000000000001                       
                        1111111111111111111111110000111111111111111111111111                       
                                               100001                                              
                                               100001                                              
                                               100001                                              
                                               100001                                              
                                               100001                                              
                                               100001                                              
                                   111111111111100001111111111111                                  
                                   100000000000000000000000000001                                  
                                   100000000000000000000000000001111                               
                                   100000000000000000000000000000001             1111111111111     
                                   100000000000000000000000000000001             1000000000001     
                                   100000000000000000000000000001111             1000000000001     
                                   100000000000000000000000000001                1000000000001     
                                   10000000000000000000000000000111111111111111111000000000001     
                                   10000000000000000000000000000000000000000000000000000000001     
                                   10000000000000000000000000000000000000000000000000000000001     
                                   10000000000000000000000000000111111111111111111000000000001     
                                   100000000000000000000000000001                1000000000001     
                                   100000000000000000000000000001                1000000000001     
                                   100000000000000000000000000001                1000000000001     
                                   100000000000000000000000000001                1111100011111     
                                   100000000000000000000000000001                    10001         
                                   100000000000000000000000000001                    10001         
                                   111111111111111111111111111111                   1100011        
                                                                                    1000001        
                                                                                    1000001        
                                                                                    1000001        
                                                                                    1000001        
                                                                                    1111111        
                                                                                                   