  111111                 
 1000001                 
10000001                 
10000001                 
10000001                 
11100111                 
  1001                   
  1001                   
11100111111111           
1000000000000111111111111
1000000000000000000000001
1000000000000111111111101
11111111001111        101
       1001           101
       1001           101
       1001           101
       100111111111111111
       100000000000000001
       100000000000000001
       111111111110000001
                 10000001
                 10000001
                 10000001
                 11111111